NO assets/test/north.xpm
SO assets/test/south.xpm
WE assets/test/west.xpm
EA assets/test/east.xpm

F 20,20,20
C 200,200,200

11111
10001
10S01
10001
10001
100011
11000
10001
10001
10001
10001
10001
11111
